Timestamp,ACC  (BIRD),ACC  (EDYY),ACC  (EGGX),ACC  (EGTT),ACC  (EHAA),ACC  (EISN),ACC  (EKDK),ACC  (ENOS),Total
2017-08-11  18:28:19.084,0,0,0,0,0,0,0,0,0
2017-08-11  18:33:19.087,0,0,0,0,0,0,0,0,0
2017-08-11  18:38:19.090,0,4,0,6,0,0,0,0,10
2017-08-11  18:43:19.092,0,14,0,16,0,0,0,0,30
2017-08-11  18:48:19.093,2,22,6,22,0,0,4,0,56
2017-08-11  18:53:19.095,4,28,12,28,0,0,4,0,76
2017-08-11  18:58:19.097,6,38,12,32,0,0,4,4,96
2017-08-11  19:03:19.099,22,40,12,44,0,0,8,8,134
2017-08-11  19:08:19.101,26,40,16,54,0,0,8,10,154
2017-08-11  19:13:19.102,26,48,20,68,0,0,8,12,182
2017-08-11  19:18:19.104,30,56,24,74,0,0,8,12,204
2017-08-11  19:23:19.107,34,60,29,84,0,0,14,12,233
2017-08-11  19:28:19.109,36,62,29,106,0,0,24,12,269
2017-08-11  19:33:19.111,36,64,30,130,0,2,28,12,302
2017-08-11  19:38:19.112,40,76,45,138,0,2,34,12,347
2017-08-11  19:43:19.149,42,90,46,154,0,5,38,16,391
2017-08-11  19:48:19.117,60,92,50,162,0,8,44,20,436
2017-08-11  19:53:19.119,62,92,55,178,0,9,44,22,462
2017-08-11  19:58:19.121,62,102,63,190,0,11,44,24,496
2017-08-11  20:03:19.123,66,110,71,198,0,12,44,24,525
2017-08-11  20:08:19.125,70,118,74,208,0,12,52,24,558
2017-08-11  20:13:19.126,72,122,78,230,0,12,60,24,598
2017-08-11  20:18:19.128,72,124,82,252,0,12,62,24,628
2017-08-11  20:23:19.130,76,134,95,262,0,14,70,24,675
2017-08-11  20:28:19.166,76,146,98,277,0,15,74,28,714
2017-08-11  20:33:19.168,96,154,108,285,0,18,80,34,775
2017-08-11  20:38:19.135,98,156,115,301,0,21,80,34,805
2017-08-11  20:43:19.136,98,166,123,313,0,23,80,36,839
2017-08-11  20:48:19.137,102,174,129,321,0,24,80,36,866
2017-08-11  20:53:19.173,108,182,132,337,0,24,88,36,907
2017-08-11  20:58:19.142,108,186,136,351,0,24,96,36,937
2017-08-11  21:03:19.144,108,188,140,376,0,25,100,36,973
2017-08-11  21:08:19.146,112,198,155,381,0,26,106,36,1014
2017-08-11  21:13:19.148,112,212,156,399,0,27,110,40,1056
2017-08-11  21:18:19.186,130,218,164,408,0,31,116,46,1113
2017-08-11  21:23:19.153,134,220,171,422,0,33,116,46,1142
2017-08-11  21:28:19.154,134,228,179,436,0,35,116,48,1176
2017-08-11  21:33:19.156,138,238,187,444,0,36,116,48,1207
2017-08-11  21:38:19.159,138,244,190,454,0,36,122,48,1232
2017-08-11  21:43:19.159,144,248,194,476,0,36,132,48,1278
2017-08-11  21:48:19.162,144,252,197,497,0,37,134,48,1309
2017-08-11  21:53:19.164,146,258,209,506,0,38,140,48,1345
2017-08-11  21:58:19.166,148,272,214,516,0,40,146,52,1388
2017-08-11  22:03:19.168,160,282,222,529,0,43,150,54,1440
2017-08-11  22:08:19.204,170,284,227,543,0,45,152,58,1479
2017-08-11  22:13:19.204,170,288,237,549,0,47,152,60,1503
2017-08-11  22:18:19.173,174,302,243,567,0,48,152,60,1546
2017-08-11  22:23:19.176,174,306,248,573,0,48,156,60,1565
2017-08-11  22:28:19.213,180,310,252,589,0,48,168,60,1607
2017-08-11  22:33:19.215,180,316,255,611,0,48,168,60,1638
2017-08-11  22:38:19.182,182,320,261,623,0,50,176,60,1672
2017-08-11  22:43:19.184,184,328,272,637,0,50,180,64,1715
2017-08-11  22:48:19.185,188,346,280,648,0,54,184,64,1764
2017-08-11  22:53:19.223,202,348,285,662,0,56,188,70,1811
2017-08-11  22:58:19.189,206,348,293,672,0,58,188,72,1837
2017-08-11  23:03:19.191,208,364,301,688,0,60,188,72,1881
2017-08-11  23:08:19.193,210,368,305,694,0,60,192,72,1901
2017-08-11  23:13:19.194,216,374,310,704,0,60,200,72,1936
2017-08-11  23:18:19.231,216,380,312,726,0,60,204,72,1970
2017-08-11  23:23:19.199,216,380,315,746,0,62,210,72,2001
2017-08-11  23:28:19.201,220,392,329,758,0,62,216,72,2049
2017-08-11  23:33:19.203,222,408,335,769,0,66,220,78,2098
2017-08-11  23:38:19.205,236,410,343,775,0,68,222,78,2132
2017-08-11  23:43:19.206,242,412,346,793,0,69,224,84,2170
2017-08-11  23:48:19.208,244,422,357,807,0,72,224,84,2210
2017-08-11  23:53:19.211,246,430,363,813,0,72,228,84,2236
2017-08-11  23:58:19.212,252,438,366,823,0,72,232,84,2267
2017-08-12  00:03:19.215,0,4,4,20,0,0,8,0,36
2017-08-12  00:08:19.216,0,6,6,43,0,2,10,0,67
2017-08-12  00:13:19.218,2,18,19,54,0,2,18,0,113
2017-08-12  00:18:19.254,4,26,23,66,0,3,22,4,148
2017-08-12  00:23:19.222,14,36,32,75,0,8,24,6,195
2017-08-12  00:28:19.227,24,38,35,91,0,8,28,12,236
2017-08-12  00:33:19.226,28,44,47,105,0,10,28,12,274
2017-08-12  00:38:19.262,30,56,51,113,0,12,32,12,306
2017-08-12  00:43:19.264,32,64,56,123,0,12,36,12,335
2017-08-12  00:48:19.233,36,66,60,139,0,12,44,12,369
2017-08-12  00:53:19.235,36,70,64,163,0,12,46,12,403
2017-08-12  00:58:19.274,38,76,73,169,0,14,52,12,434
2017-08-12  01:03:19.238,40,84,81,183,0,14,56,16,474
2017-08-12  01:08:19.239,44,100,90,194,0,19,60,18,525
2017-08-12  01:13:19.241,58,102,93,212,0,20,62,20,567
2017-08-12  01:18:19.243,64,106,105,218,0,22,64,24,603
2017-08-12  01:23:19.245,64,120,109,236,0,24,68,24,645
2017-08-12  01:28:19.281,68,124,113,244,0,24,72,24,669
2017-08-12  01:33:19.249,72,128,118,254,0,24,76,24,696
2017-08-12  01:38:19.287,72,134,121,278,0,24,80,24,733
2017-08-12  01:43:19.253,74,136,123,292,0,26,86,24,761
2017-08-12  01:48:19.256,76,146,139,306,0,26,92,24,809
2017-08-12  01:53:19.257,78,160,146,316,0,30,96,30,856
2017-08-12  01:58:19.259,88,166,151,332,0,32,96,32,897
2017-08-12  02:03:19.296,98,168,160,340,0,33,100,36,935
2017-08-12  02:08:19.263,100,180,167,356,0,36,104,36,979
2017-08-12  02:13:19.264,104,184,171,366,0,36,106,36,1003
2017-08-12  02:18:19.300,108,192,174,374,0,36,110,36,1030
2017-08-12  02:23:19.268,108,198,178,396,0,37,116,36,1069
2017-08-12  02:28:19.270,108,198,181,416,0,38,122,36,1099
2017-08-12  02:33:19.306,112,210,196,424,0,39,126,36,1143
2017-08-12  02:38:19.274,112,214,201,435,0,40,132,42,1176
2017-08-12  02:43:19.276,118,228,209,453,0,44,132,44,1228
2017-08-12  02:48:19.313,130,230,214,459,0,45,136,44,1258
2017-08-12  02:53:19.313,136,242,221,475,0,47,138,48,1307
2017-08-12  02:58:19.281,138,248,229,487,0,49,142,48,1341
2017-08-12  03:03:19.318,144,256,231,495,0,49,144,48,1367
2017-08-12  03:08:19.285,144,260,235,509,0,49,150,48,1395
2017-08-12  03:13:19.320,144,262,238,535,0,50,154,48,1431
2017-08-12  03:18:19.288,146,270,248,545,0,51,162,48,1470
2017-08-12  03:23:19.323,148,278,257,558,0,52,166,50,1509
2017-08-12  03:28:19.324,150,288,264,571,0,55,168,56,1552
2017-08-12  03:33:19.293,164,294,271,583,0,57,170,56,1595
2017-08-12  03:38:19.327,172,302,277,589,0,57,174,60,1631
2017-08-12  03:43:19.330,174,312,283,611,0,60,178,60,1678
2017-08-12  03:48:19.297,176,316,287,619,0,61,180,60,1699
2017-08-12  03:53:19.333,180,322,292,627,0,61,184,60,1726
2017-08-12  03:58:19.302,180,326,296,651,0,61,188,60,1762
2017-08-12  04:03:19.303,182,332,302,665,0,63,196,60,1800
2017-08-12  04:08:19.343,184,340,313,675,0,63,200,62,1837
2017-08-12  04:13:19.307,186,346,322,690,0,65,204,68,1881
2017-08-12  04:18:19.344,190,358,329,704,0,69,204,68,1922
2017-08-12  04:23:19.311,204,364,335,712,0,69,210,72,1966
2017-08-12  04:28:19.313,210,376,341,732,0,71,214,72,2016
2017-08-12  04:33:19.314,210,378,345,740,0,73,216,72,2034
2017-08-12  04:38:19.317,216,384,350,746,0,73,218,72,2059
2017-08-12  04:43:19.318,216,390,353,770,0,73,222,72,2096
2017-08-12  04:48:19.320,216,390,356,786,0,74,230,72,2124
2017-08-12  04:53:19.356,220,402,366,796,0,75,236,74,2169
2017-08-12  04:58:19.323,222,408,378,811,0,76,240,78,2213
2017-08-12  05:03:19.358,224,418,387,823,0,80,240,80,2252
2017-08-12  05:08:19.361,236,428,390,831,0,81,244,80,2290
2017-08-12  05:13:19.363,244,440,397,839,0,83,250,84,2337
2017-08-12  05:18:19.330,246,440,403,859,0,85,252,84,2369
2017-08-12  05:23:19.332,252,448,405,867,0,85,252,84,2393
2017-08-12  05:28:19.334,252,452,411,885,0,85,258,84,2427
2017-08-12  05:33:19.336,252,454,413,906,0,86,264,84,2459
2017-08-12  05:38:19.338,254,464,420,913,0,87,270,86,2494
2017-08-12  05:43:19.339,256,472,435,929,0,88,274,86,2540
2017-08-12  05:48:19.341,260,474,442,942,0,90,276,92,2576
2017-08-12  05:53:19.343,264,492,447,954,0,93,276,92,2618
2017-08-12  05:58:19.346,278,502,453,958,0,93,284,96,2664
2017-08-12  06:03:19.348,282,504,457,980,0,95,288,96,2702
2017-08-12  06:08:19.349,282,510,461,988,0,97,288,96,2722
2017-08-12  06:13:19.385,288,512,469,1002,0,97,292,96,2756
2017-08-12  06:18:19.354,288,518,471,1018,0,97,296,96,2784
2017-08-12  06:23:19.355,290,524,474,1032,0,98,304,98,2820
2017-08-12  06:28:19.357,292,534,489,1046,0,99,308,98,2866
2017-08-12  06:33:19.358,294,536,500,1059,0,101,312,104,2906
2017-08-12  06:38:19.361,298,550,505,1075,0,104,312,104,2948
2017-08-12  06:43:19.363,310,564,509,1079,0,105,318,104,2989
2017-08-12  06:48:19.364,318,568,515,1097,0,107,324,108,3037
2017-08-12  06:53:19.366,318,572,519,1109,0,109,324,108,3059
2017-08-12  06:58:19.368,324,576,525,1119,0,109,326,108,3087
2017-08-12  07:03:19.371,324,582,527,1139,0,109,328,108,3117
2017-08-12  07:08:19.373,324,582,530,1154,0,110,338,110,3148
2017-08-12  07:13:19.375,328,594,540,1167,0,111,344,110,3194
2017-08-12  07:18:19.376,330,598,554,1180,0,112,348,112,3234
2017-08-12  07:23:19.411,334,610,563,1196,0,114,348,116,3281
2017-08-12  07:28:19.414,338,628,564,1202,0,117,352,116,3317
2017-08-12  07:33:19.415,350,632,571,1216,0,117,360,120,3366
2017-08-12  07:38:19.384,354,632,577,1226,0,119,360,120,3388
2017-08-12  07:43:19.386,360,638,580,1238,0,121,360,120,3417
2017-08-12  07:48:19.389,360,642,585,1254,0,121,364,120,3446
2017-08-12  07:53:19.391,360,646,588,1273,0,122,372,120,3481
2017-08-12  07:58:19.392,362,654,592,1282,0,122,378,122,3512
2017-08-12  08:03:19.395,364,662,611,1298,0,124,382,124,3565
2017-08-12  08:08:19.396,370,668,620,1311,0,125,384,128,3606
2017-08-12  08:13:19.399,370,692,621,1325,0,128,388,128,3652
2017-08-12  08:18:19.434,384,696,627,1331,0,129,394,128,3689
2017-08-12  08:23:19.403,390,696,633,1343,0,131,396,132,3721
2017-08-12  08:28:19.405,394,702,636,1361,0,133,396,132,3754
2017-08-12  08:33:19.407,396,704,642,1369,0,133,400,132,3776
2017-08-12  08:38:19.409,396,710,645,1385,0,134,404,132,3806
2017-08-12  08:43:19.412,398,712,648,1405,0,134,412,134,3843
2017-08-12  08:48:19.447,400,720,657,1419,0,136,416,134,3882
2017-08-12  08:53:19.416,402,728,676,1424,0,136,420,136,3922
2017-08-12  08:58:19.419,406,742,679,1444,0,140,422,140,3973
2017-08-12  09:03:19.420,408,760,685,1450,0,141,426,140,4010
2017-08-12  09:08:19.422,424,760,687,1460,0,142,432,144,4049
2017-08-12  09:13:19.424,426,764,693,1472,0,145,432,144,4076
2017-08-12  09:18:19.458,430,768,700,1490,0,145,434,144,4111
2017-08-12  09:23:19.464,432,774,702,1500,0,145,436,144,4133
2017-08-12  09:28:19.465,432,776,703,1516,0,146,444,146,4163
2017-08-12  09:33:19.433,436,780,713,1534,0,146,452,146,4207
2017-08-12  09:38:19.436,438,788,725,1546,0,148,456,148,4249
2017-08-12  09:43:19.438,442,800,735,1559,0,149,458,148,4291
2017-08-12  09:48:19.477,442,820,742,1571,0,152,462,152,4341
2017-08-12  09:53:19.442,458,824,743,1581,0,153,466,152,4377
2017-08-12  09:58:19.443,462,826,751,1587,0,155,468,156,4405
2017-08-12  10:03:19.446,466,830,756,1609,0,157,468,156,4442
2017-08-12  10:08:19.447,468,834,759,1619,0,157,472,156,4465
2017-08-12  10:13:19.450,468,838,761,1631,0,158,476,158,4490
2017-08-12  10:18:19.452,470,840,769,1652,0,158,484,158,4531
2017-08-12  10:23:19.454,472,850,779,1667,0,160,490,160,4578
2017-08-12  10:28:19.492,476,860,792,1681,0,161,492,160,4622
2017-08-12  10:33:19.492,478,878,799,1693,0,161,496,164,4669
2017-08-12  10:38:19.460,484,888,801,1705,0,165,500,164,4707
2017-08-12  10:43:19.462,498,888,805,1707,0,165,504,168,4735
2017-08-12  10:48:19.464,498,894,812,1731,0,167,504,168,4774
2017-08-12  10:53:19.465,504,894,817,1743,0,169,508,168,4803
2017-08-12  10:58:19.467,504,900,819,1753,0,170,512,170,4828
2017-08-12  11:03:19.504,506,904,826,1767,0,170,516,170,4859
2017-08-12  11:08:19.471,508,910,831,1785,0,171,524,172,4901
2017-08-12  11:13:19.472,512,924,848,1796,0,173,528,172,4953
2017-08-12  11:18:19.474,514,940,855,1810,0,173,532,172,4996
2017-08-12  11:23:19.477,518,952,859,1828,0,176,536,176,5045
2017-08-12  11:28:19.479,530,952,863,1828,0,177,540,176,5066
2017-08-12  11:33:19.480,534,956,870,1844,0,179,540,180,5103
2017-08-12  11:38:19.515,538,958,874,1860,0,181,542,180,5133
2017-08-12  11:43:19.520,540,964,876,1866,0,181,548,182,5157
2017-08-12  11:48:19.486,540,968,884,1890,0,182,550,182,5196
2017-08-12  11:53:19.489,542,968,889,1905,0,182,558,184,5228
2017-08-12  11:58:19.491,548,982,900,1918,0,184,564,184,5280
2017-08-12  12:03:19.492,550,1000,913,1929,0,185,568,184,5329
2017-08-12  12:08:19.494,552,1012,915,1947,0,186,572,188,5372
2017-08-12  12:13:19.526,558,1016,921,1951,0,189,572,188,5395
2017-08-12  12:18:19.499,570,1020,926,1961,0,189,576,192,5434
2017-08-12  12:23:19.501,574,1022,929,1979,0,191,578,192,5465
2017-08-12  12:28:19.502,576,1026,934,1989,0,193,584,194,5496
2017-08-12  12:33:19.504,576,1030,942,2005,0,194,584,194,5525
2017-08-12  12:38:19.539,578,1032,947,2023,0,194,592,196,5562
2017-08-12  12:43:19.544,584,1042,954,2037,0,195,600,196,5608
2017-08-12  12:48:19.511,584,1062,969,2044,0,197,604,196,5656
2017-08-12  12:53:19.514,588,1070,973,2070,0,197,608,200,5706
2017-08-12  12:58:19.564,590,1080,979,2074,0,200,608,200,5731
2017-08-12  13:03:19.550,602,1084,983,2084,0,201,612,200,5766
2017-08-12  13:08:19.520,610,1086,986,2096,0,203,612,204,5797
2017-08-12  13:13:19.554,610,1088,992,2112,0,205,620,204,5831
2017-08-12  13:18:19.523,612,1094,998,2128,0,206,620,204,5862
2017-08-12  13:23:19.547,614,1106,1012,2138,0,206,630,204,5910
2017-08-12  13:28:19.536,616,1116,1018,2152,0,207,634,208,5951
2017-08-12  13:33:19.552,634,1126,1022,2162,0,209,640,212,6005
2017-08-12  13:38:19.590,638,1126,1025,2179,0,209,640,214,6031
2017-08-12  13:43:19.554,638,1134,1035,2191,0,211,640,216,6065
2017-08-12  13:48:19.603,642,1146,1037,2199,0,213,640,216,6093
2017-08-12  13:53:19.587,642,1150,1044,2209,0,214,646,216,6121
2017-08-12  13:58:19.646,648,1152,1049,2229,0,217,656,216,6167
2017-08-12  14:03:19.674,648,1158,1049,2251,0,218,658,216,6198
2017-08-12  14:08:19.622,650,1164,1065,2261,0,219,664,216,6239
2017-08-12  14:13:19.590,652,1180,1072,2271,0,220,670,220,6285
2017-08-12  14:18:19.592,666,1190,1074,2284,0,224,674,224,6336
2017-08-12  14:23:19.649,674,1190,1081,2298,0,226,676,226,6371
2017-08-12  14:28:19.691,674,1194,1089,2304,0,228,676,226,6391
2017-08-12  14:33:19.624,678,1208,1095,2322,0,229,676,228,6436
2017-08-12  14:38:19.693,678,1212,1100,2330,0,229,680,228,6457
2017-08-12  14:43:19.697,684,1218,1104,2342,0,229,688,228,6493
2017-08-12  14:48:19.658,684,1222,1106,2366,0,229,692,228,6527
2017-08-12  14:53:19.657,686,1226,1113,2380,0,231,698,228,6562
2017-08-12  14:58:19.710,688,1234,1124,2392,0,232,704,232,6606
2017-08-12  15:03:19.753,696,1252,1130,2403,0,235,708,232,6656
2017-08-12  15:08:19.684,708,1254,1137,2417,0,238,712,238,6704
2017-08-12  15:13:19.714,710,1254,1145,2425,0,240,712,238,6724
2017-08-12  15:18:19.697,710,1270,1153,2443,0,241,712,240,6769
2017-08-12  15:23:19.740,714,1274,1157,2447,0,241,714,240,6787
2017-08-12  15:28:19.745,720,1280,1162,2465,0,241,722,240,6830
2017-08-12  15:33:19.720,720,1286,1164,2483,0,241,728,240,6862
2017-08-12  15:38:19.751,722,1288,1167,2495,0,243,732,242,6889
2017-08-12  15:43:19.756,724,1292,1169,2515,0,243,736,242,6921
2017-08-12  15:48:19.698,726,1294,1177,2532,0,246,740,244,6959
2017-08-12  15:53:19.776,732,1308,1189,2534,0,249,748,244,7004
2017-08-12  15:58:19.759,732,1326,1198,2538,0,250,752,244,7040
2017-08-12  16:03:19.804,736,1326,1206,2560,0,253,756,248,7085
2017-08-12  16:08:19.814,736,1340,1214,2566,0,253,756,248,7113
2017-08-12  16:13:19.796,750,1346,1217,2574,0,253,758,248,7146
2017-08-12  16:18:19.787,758,1350,1222,2586,0,253,762,252,7183
2017-08-12  16:23:19.793,758,1350,1227,2602,0,254,768,254,7213
2017-08-12  16:28:19.789,760,1354,1230,2614,0,255,768,254,7235
2017-08-12  16:33:19.912,762,1354,1239,2632,0,256,774,256,7273
2017-08-12  16:38:19.820,766,1362,1245,2648,0,257,780,256,7314
2017-08-12  16:43:19.886,768,1384,1255,2656,0,260,788,256,7367
2017-08-12  16:48:19.603,772,1392,1264,2677,0,260,792,256,7413
2017-08-12  16:53:19.606,772,1400,1271,2687,0,262,792,260,7444
2017-08-12  16:58:19.609,778,1408,1275,2697,0,264,792,260,7474
2017-08-12  17:03:19.611,794,1410,1277,2703,0,265,796,264,7509
2017-08-12  17:08:19.613,794,1410,1283,2721,0,268,804,266,7546
2017-08-12  17:13:19.615,796,1418,1292,2735,0,268,804,266,7579
2017-08-12  17:18:19.616,798,1418,1295,2749,0,269,808,268,7605
2017-08-12  17:23:19.619,800,1424,1303,2764,0,270,812,268,7641
2017-08-12  17:28:19.620,804,1444,1309,2779,0,272,824,268,7700
2017-08-12  17:33:19.622,806,1454,1322,2794,0,273,828,268,7745
2017-08-12  17:38:19.624,808,1456,1328,2806,0,274,828,272,7772
2017-08-12  17:43:19.626,810,1472,1332,2820,0,277,828,272,7811
2017-08-12  17:48:19.629,822,1474,1336,2826,0,277,830,272,7837
2017-08-12  17:53:19.630,830,1474,1339,2842,0,279,840,276,7880
2017-08-12  17:58:19.633,830,1476,1346,2856,0,281,840,278,7907
2017-08-12  18:03:19.635,832,1482,1352,2866,0,282,844,280,7938
2017-08-12  18:08:19.637,836,1488,1360,2880,0,282,846,280,7972
2017-08-12  18:13:19.639,838,1502,1367,2900,0,283,858,280,8028
2017-08-12  18:18:19.641,842,1516,1374,2912,0,285,864,280,8073
2017-08-12  18:23:19.643,844,1518,1384,2925,0,285,864,280,8100
2017-08-12  18:28:19.645,844,1532,1388,2941,0,287,864,284,8140
2017-08-12  18:33:19.648,852,1538,1393,2947,0,290,866,284,8170
2017-08-12  18:38:19.649,864,1538,1395,2953,0,290,876,288,8204
2017-08-12  18:43:19.652,866,1540,1402,2973,0,293,876,290,8240
2017-08-12  18:48:19.654,868,1546,1408,2985,0,294,880,292,8273
2017-08-12  18:53:19.656,870,1548,1418,3001,0,295,880,292,8304
2017-08-12  18:58:19.660,872,1564,1421,3020,0,295,888,292,8352
2017-08-12  19:03:19.661,878,1576,1430,3035,0,297,900,292,8408
2017-08-12  19:08:19.662,878,1582,1442,3046,0,298,900,292,8438
2017-08-12  19:13:19.663,880,1590,1446,3058,0,299,900,296,8469
2017-08-12  19:18:19.701,882,1602,1451,3070,0,302,900,296,8503
2017-08-12  19:23:19.668,898,1602,1453,3076,0,302,910,300,8541
2017-08-12  19:28:19.670,902,1604,1459,3090,0,304,912,302,8573
2017-08-12  19:33:19.672,902,1608,1466,3114,0,306,914,302,8612
2017-08-12  19:38:19.674,908,1612,1475,3122,0,307,916,304,8644
2017-08-12  19:43:19.676,910,1628,1477,3142,0,307,924,304,8692
2017-08-12  19:48:19.678,914,1640,1490,3154,0,308,934,304,8744
2017-08-12  19:53:19.680,916,1646,1498,3171,0,310,936,304,8781
2017-08-12  19:58:19.717,916,1656,1504,3183,0,310,936,308,8813
2017-08-12  20:03:19.685,922,1666,1509,3193,0,313,938,308,8849
2017-08-12  20:08:19.723,938,1666,1510,3203,0,314,946,312,8889
2017-08-12  20:13:19.689,938,1668,1517,3213,0,316,948,314,8914
2017-08-12  20:18:19.691,940,1672,1524,3233,0,318,950,316,8953
2017-08-12  20:23:19.693,944,1674,1529,3241,0,319,952,316,8975
2017-08-12  20:28:19.695,944,1688,1535,3263,0,319,960,316,9025
2017-08-12  20:33:19.696,950,1702,1550,3279,0,321,970,316,9088
2017-08-12  20:38:19.731,950,1710,1556,3288,0,322,972,320,9118
2017-08-12  20:43:19.700,952,1724,1561,3308,0,322,972,320,9159
2017-08-12  20:48:19.702,960,1730,1567,3316,0,326,972,320,9191
2017-08-12  20:53:19.704,974,1730,1569,3326,0,326,984,324,9233
2017-08-12  20:58:19.707,974,1732,1574,3340,0,328,984,326,9258
2017-08-12  21:03:19.708,976,1736,1582,3356,0,330,988,328,9296
2017-08-12  21:08:19.711,980,1740,1590,3368,0,331,988,328,9325
2017-08-12  21:13:19.713,980,1750,1594,3389,0,331,996,328,9368
2017-08-12  21:18:19.715,986,1768,1604,3398,0,333,1006,328,9423
2017-08-12  21:23:19.751,988,1776,1616,3413,0,334,1008,328,9463
2017-08-12  21:28:19.719,988,1784,1618,3425,0,335,1008,332,9490
2017-08-12  21:33:19.754,990,1794,1625,3439,0,338,1008,332,9526
2017-08-12  21:38:19.723,1008,1794,1627,3443,0,338,1016,332,9558
2017-08-12  21:43:19.758,1010,1794,1633,3457,0,340,1020,338,9592
2017-08-12  21:48:19.726,1012,1798,1640,3477,0,342,1022,338,9629
2017-08-12  21:53:19.728,1014,1802,1647,3487,0,343,1024,340,9657
2017-08-12  21:58:19.730,1016,1812,1650,3509,0,343,1028,340,9698
2017-08-12  22:03:19.731,1020,1830,1657,3519,0,344,1042,340,9752
2017-08-12  22:08:19.734,1022,1838,1670,3536,0,346,1044,340,9796
2017-08-12  22:13:19.735,1024,1844,1674,3540,0,346,1044,344,9816
2017-08-12  22:18:19.772,1026,1858,1681,3562,0,349,1044,344,9864
2017-08-12  22:23:19.740,1040,1858,1685,3564,0,350,1048,344,9889
2017-08-12  22:28:19.776,1046,1858,1687,3576,0,351,1056,350,9924
2017-08-12  22:33:19.742,1046,1862,1698,3596,0,354,1056,350,9962
2017-08-12  22:38:19.743,1048,1866,1702,3606,0,355,1060,352,9989
2017-08-12  22:43:19.747,1052,1874,1708,3628,0,355,1062,352,10031
2017-08-12  22:48:19.781,1054,1886,1715,3638,0,355,1076,352,10076
2017-08-12  22:53:19.783,1058,1900,1724,3652,0,358,1080,352,10124
2017-08-12  22:58:19.786,1060,1906,1732,3664,0,358,1080,356,10156
2017-08-12  23:03:19.753,1060,1918,1739,3682,0,361,1080,356,10196
2017-08-12  23:08:19.755,1072,1922,1742,3686,0,362,1082,356,10222
2017-08-12  23:13:19.792,1082,1922,1745,3698,0,364,1092,360,10263
2017-08-12  23:18:19.760,1082,1924,1754,3718,0,366,1092,362,10298
2017-08-12  23:23:19.763,1084,1930,1758,3728,0,366,1096,364,10326
2017-08-12  23:28:19.764,1088,1936,1766,3744,0,367,1096,364,10361
2017-08-12  23:33:19.766,1088,1948,1771,3760,0,367,1108,364,10406
2017-08-12  23:38:19.769,1094,1962,1778,3772,0,369,1116,364,10455
2017-08-12  23:43:19.806,1094,1966,1790,3785,0,370,1116,364,10485
2017-08-12  23:48:19.773,1096,1978,1796,3801,0,371,1116,368,10526
2017-08-12  23:53:19.775,1102,1986,1799,3809,0,374,1116,368,10554
2017-08-12  23:58:19.777,1116,1986,1801,3815,0,374,1126,372,10590
2017-08-13  00:03:19.780,2,2,10,14,0,2,2,2,34
2017-08-13  00:08:19.781,4,6,13,32,0,4,4,4,67
2017-08-13  00:13:19.782,8,10,22,42,0,5,6,4,97
2017-08-13  00:18:19.784,8,22,24,64,0,5,14,4,141
2017-08-13  00:23:19.786,14,38,35,74,0,7,24,4,196
2017-08-13  00:28:19.820,14,44,45,91,0,8,26,4,232
2017-08-13  00:33:19.788,16,50,50,104,0,9,26,8,263
2017-08-13  00:38:19.790,16,64,56,118,0,12,26,8,300
2017-08-13  00:43:19.827,36,64,58,122,0,12,34,8,334
2017-08-13  00:48:19.829,38,66,62,136,0,14,38,14,368
2017-08-13  00:53:19.797,40,68,71,154,0,16,38,14,401
2017-08-13  00:58:19.798,42,72,78,162,0,17,42,16,429
2017-08-13  01:03:19.801,44,82,81,184,0,17,44,16,468
2017-08-13  01:08:19.801,48,100,89,196,0,19,60,16,528
2017-08-13  01:13:19.803,50,108,101,208,0,20,62,16,565
2017-08-13  01:18:19.807,52,112,105,219,0,20,62,20,590
2017-08-13  01:23:19.807,52,128,114,239,0,23,62,20,638
2017-08-13  01:28:19.809,68,128,115,243,0,24,64,20,662
2017-08-13  01:33:19.812,74,128,118,253,0,26,74,26,699
2017-08-13  01:38:19.814,74,130,129,271,0,29,74,26,733
2017-08-13  01:43:19.817,76,136,133,283,0,29,78,28,763
2017-08-13  01:48:19.819,80,142,139,299,0,30,80,28,798
2017-08-13  01:53:19.820,82,154,146,316,0,30,92,28,848
2017-08-13  01:58:19.858,86,170,153,329,0,32,98,28,896
2017-08-13  02:03:19.828,88,176,163,341,0,33,98,32,931
2017-08-13  02:08:19.862,88,188,170,359,0,35,98,32,970
2017-08-13  02:13:19.829,100,192,172,365,0,37,100,32,998
2017-08-13  02:18:19.832,110,192,174,377,0,37,110,36,1036
2017-08-13  02:23:19.834,110,194,187,391,0,39,110,38,1069
2017-08-13  02:28:19.835,112,200,187,405,0,41,112,40,1097
2017-08-13  02:33:19.837,116,206,197,421,0,42,114,40,1136
2017-08-13  02:38:19.839,116,216,202,439,0,42,124,40,1179
2017-08-13  02:43:19.876,122,228,209,451,0,44,134,40,1228
2017-08-13  02:48:19.875,122,236,221,462,0,45,134,40,1260
2017-08-13  02:53:19.843,124,246,225,480,0,46,134,44,1299
2017-08-13  02:58:19.845,126,256,230,488,0,49,134,44,1327
2017-08-13  03:03:19.848,144,256,232,498,0,49,144,48,1371
2017-08-13  03:08:19.850,146,258,238,506,0,51,146,50,1395
2017-08-13  03:13:19.852,148,262,245,524,0,53,148,50,1430
2017-08-13  03:18:19.889,152,264,252,534,0,54,150,52,1458
2017-08-13  03:23:19.856,152,276,255,558,0,54,156,52,1503
2017-08-13  03:28:19.858,158,294,265,568,0,55,168,52,1560
2017-08-13  03:33:19.861,158,300,277,585,0,57,170,52,1599
2017-08-13  03:38:19.863,160,306,279,593,0,57,170,56,1621
2017-08-13  03:43:19.864,160,320,288,611,0,60,170,56,1665
2017-08-13  03:48:19.903,178,320,290,615,0,61,174,56,1694
2017-08-13  03:53:19.903,182,320,292,629,0,63,182,62,1730
2017-08-13  03:58:19.904,182,324,303,645,0,65,182,62,1763
2017-08-13  04:03:19.873,184,328,309,655,0,66,186,64,1792
2017-08-13  04:08:19.875,188,336,313,673,0,66,188,64,1828
2017-08-13  04:13:19.877,190,352,321,687,0,67,200,64,1881
2017-08-13  04:18:19.880,194,364,331,701,0,69,206,64,1929
2017-08-13  04:23:19.882,196,368,337,716,0,69,206,68,1960
2017-08-13  04:28:19.884,196,382,346,730,0,72,206,68,2000
2017-08-13  04:33:19.886,208,384,347,734,0,73,210,68,2024
2017-08-13  04:38:19.889,218,384,350,746,0,74,218,72,2062
2017-08-13  04:43:19.891,218,386,361,762,0,77,218,74,2096
2017-08-13  04:48:19.925,220,392,363,776,0,77,222,76,2126
2017-08-13  04:53:19.896,224,400,371,788,0,78,224,76,2161
2017-08-13  04:58:19.897,226,410,376,806,0,78,234,76,2206
2017-08-13  05:03:19.900,230,426,387,820,0,80,242,76,2261
2017-08-13  05:08:19.901,232,432,395,836,0,81,242,80,2298
2017-08-13  05:13:19.903,232,442,400,850,0,82,242,80,2328
2017-08-13  05:18:19.904,240,448,404,858,0,85,242,80,2357
2017-08-13  05:23:19.941,254,448,406,868,0,85,254,84,2399
2017-08-13  05:28:19.907,254,450,412,878,0,87,254,86,2421
2017-08-13  05:33:19.942,256,456,419,896,0,89,256,88,2460
2017-08-13  05:38:19.911,260,460,429,910,0,90,258,88,2495
2017-08-13  05:43:19.912,260,468,430,930,0,90,268,88,2534
2017-08-13  05:48:19.914,266,486,441,940,0,92,276,88,2589
2017-08-13  05:53:19.917,266,492,453,951,0,93,278,88,2621
2017-08-13  05:58:19.919,268,500,456,965,0,94,278,92,2653
2017-08-13  06:03:19.920,270,512,462,981,0,97,278,92,2692
2017-08-13  06:08:19.923,288,512,464,987,0,97,288,92,2728
2017-08-13  06:13:19.925,290,514,468,999,0,99,290,98,2758
2017-08-13  06:18:19.927,292,516,477,1017,0,101,290,98,2791
2017-08-13  06:23:19.929,294,520,483,1027,0,102,294,100,2820
2017-08-13  06:28:19.964,296,530,487,1051,0,102,298,100,2864
2017-08-13  06:33:19.932,302,550,495,1057,0,104,312,100,2920
2017-08-13  06:38:19.968,302,556,505,1073,0,105,314,100,2955
2017-08-13  06:43:19.937,304,562,511,1082,0,105,314,104,2982
2017-08-13  06:48:19.939,304,576,520,1102,0,109,314,104,3029
2017-08-13  06:53:19.974,320,576,521,1106,0,109,320,104,3056
2017-08-13  06:58:19.975,326,576,524,1118,0,111,326,110,3091
2017-08-13  07:03:19.945,326,580,535,1136,0,113,326,110,3126
2017-08-13  07:08:19.981,328,584,539,1148,0,114,330,112,3155
2017-08-13  07:13:19.950,332,594,545,1164,0,114,332,112,3193
2017-08-13  07:18:19.986,332,606,552,1180,0,115,344,112,3241
2017-08-13  07:23:19.986,338,620,561,1194,0,117,350,112,3292
2017-08-13  07:28:19.956,340,622,569,1205,0,117,350,116,3319
2017-08-13  07:33:19.992,340,638,576,1223,0,119,350,116,3362
2017-08-13  07:38:19.996,350,640,578,1227,0,121,352,116,3384
2017-08-13  07:43:19.961,362,640,580,1239,0,122,362,120,3425
2017-08-13  07:48:19.963,362,642,593,1253,0,124,362,122,3458
2017-08-13  07:53:19.965,364,648,593,1269,0,125,366,124,3489
2017-08-13  07:58:20.003,368,652,603,1285,0,126,366,124,3524
2017-08-13  08:03:20.002,368,666,606,1302,0,126,376,124,3568
2017-08-13  08:08:19.971,374,682,617,1315,0,128,386,124,3626
2017-08-13  08:13:19.974,376,684,627,1324,0,129,386,124,3650
2017-08-13  08:18:19.976,376,696,632,1338,0,130,386,128,3686
2017-08-13  08:23:19.977,378,704,636,1350,0,133,386,128,3715
2017-08-13  08:28:19.980,396,704,638,1356,0,133,396,132,3755
2017-08-13  08:33:19.982,398,706,646,1368,0,135,398,134,3785
2017-08-13  08:38:19.984,400,710,651,1386,0,137,400,136,3820
2017-08-13  08:43:19.986,404,712,659,1398,0,138,402,136,3849
2017-08-13  08:48:19.988,404,726,662,1422,0,138,408,136,3896
2017-08-13  08:53:19.989,410,740,671,1436,0,140,420,136,3953
2017-08-13  08:58:19.992,410,748,685,1443,0,141,422,136,3985
2017-08-13  09:03:19.994,412,754,687,1457,0,142,422,140,4014
2017-08-13  09:08:19.996,414,768,694,1473,0,145,422,140,4056
2017-08-13  09:13:19.998,430,768,696,1477,0,145,430,140,4086
2017-08-13  09:18:19.999,434,768,698,1491,0,147,434,146,4118
2017-08-13  09:23:20.001,434,772,709,1507,0,149,434,146,4151
2017-08-13  09:28:20.004,436,776,716,1519,0,150,438,148,4183
2017-08-13  09:33:20.005,440,786,719,1539,0,150,440,148,4222
2017-08-13  09:38:20.007,444,800,727,1549,0,151,456,148,4275
2017-08-13  09:43:20.009,446,812,737,1563,0,153,458,148,4317
2017-08-13  09:48:20.012,448,818,743,1574,0,153,458,152,4346
2017-08-13  09:53:20.013,448,830,752,1594,0,156,458,152,4390
2017-08-13  09:58:20.049,460,832,753,1596,0,157,464,152,4414
2017-08-13  10:03:20.019,470,832,756,1612,0,159,470,158,4457
2017-08-13  10:08:20.019,470,834,767,1626,0,161,470,158,4486
2017-08-13  10:13:20.021,472,840,769,1640,0,162,474,160,4517
2017-08-13  10:18:20.023,476,848,777,1656,0,162,474,160,4553
2017-08-13  10:23:20.025,478,860,784,1672,0,162,488,160,4604
2017-08-13  10:28:20.061,482,876,791,1684,0,165,494,160,4652
2017-08-13  10:33:20.029,484,876,801,1695,0,165,494,164,4679
2017-08-13  10:38:20.030,484,890,807,1711,0,167,494,164,4717
2017-08-13  10:43:20.032,492,896,810,1719,0,169,496,164,4746
2017-08-13  10:48:20.034,506,896,812,1729,0,170,506,168,4787
2017-08-13  10:53:20.036,506,898,823,1739,0,172,506,170,4814
2017-08-13  10:58:20.038,508,904,825,1759,0,173,508,172,4849
2017-08-13  11:03:20.039,510,908,834,1773,0,174,510,172,4881
2017-08-13  11:08:20.041,512,918,840,1792,0,174,518,172,4926
2017-08-13  11:13:20.075,518,934,847,1807,0,176,530,172,4984
2017-08-13  11:18:20.044,520,940,857,1816,0,177,530,172,5012
2017-08-13  11:23:20.046,520,950,862,1828,0,179,530,176,5045
2017-08-13  11:28:20.048,522,960,868,1842,0,181,530,176,5079
2017-08-13  11:33:20.049,540,960,870,1848,0,182,538,180,5118
2017-08-13  11:38:20.086,542,962,874,1860,0,184,542,182,5146
2017-08-13  11:43:20.053,544,964,883,1878,0,185,544,182,5180
2017-08-13  11:48:20.054,546,968,890,1888,0,186,546,184,5208
2017-08-13  11:53:20.056,548,978,893,1912,0,186,552,184,5253
2017-08-13  11:58:20.058,552,998,901,1922,0,188,564,184,5309
2017-08-13  12:03:20.059,554,1004,913,1935,0,189,566,184,5345
2017-08-13  12:08:20.061,556,1010,917,1947,0,190,566,188,5374
2017-08-13  12:13:20.063,556,1024,926,1963,0,193,566,188,5416
2017-08-13  12:18:20.064,574,1024,928,1967,0,193,570,188,5444
2017-08-13  12:23:20.067,578,1024,930,1979,0,195,578,194,5478
2017-08-13  12:28:20.068,578,1028,941,1999,0,197,578,194,5515
2017-08-13  12:33:20.070,580,1032,947,2009,0,198,582,196,5544
2017-08-13  12:38:20.107,584,1040,951,2025,0,198,584,196,5578
2017-08-13  12:43:20.073,586,1054,958,2041,0,199,598,196,5632
2017-08-13  12:48:20.075,590,1068,967,2055,0,201,602,196,5679
2017-08-13  12:53:20.077,592,1072,975,2066,0,201,602,200,5708
2017-08-13  12:58:20.079,592,1084,982,2082,0,204,602,200,5746
2017-08-13  13:03:20.081,604,1088,985,2088,0,205,604,200,5774
2017-08-13  13:08:20.117,614,1088,988,2100,0,207,614,204,5815
2017-08-13  13:13:20.085,614,1090,999,2112,0,209,614,206,5844
2017-08-13  13:18:20.087,616,1096,1003,2128,0,209,618,208,5878
2017-08-13  13:23:20.123,620,1102,1009,2148,0,210,618,208,5915
2017-08-13  13:28:20.127,620,1114,1014,2163,0,210,632,208,5961
2017-08-13  13:33:20.093,626,1130,1025,2176,0,212,638,208,6015
2017-08-13  13:38:20.131,628,1132,1033,2185,0,213,638,212,6041
2017-08-13  13:43:20.098,628,1144,1037,2205,0,215,638,212,6079
2017-08-13  13:48:20.099,630,1152,1042,2211,0,217,638,212,6102
2017-08-13  13:53:20.101,648,1152,1044,2217,0,217,648,216,6142
2017-08-13  13:58:20.103,650,1154,1050,2229,0,220,650,218,6171
2017-08-13  14:03:20.139,652,1160,1057,2247,0,221,652,220,6209
2017-08-13  14:08:20.107,654,1162,1067,2265,0,222,654,220,6244
2017-08-13  14:13:20.109,656,1172,1068,2284,0,222,662,220,6284
2017-08-13  14:18:20.112,662,1188,1079,2293,0,224,672,220,6338
2017-08-13  14:23:20.114,662,1196,1091,2308,0,225,674,220,6376
2017-08-13  14:28:20.155,664,1206,1093,2320,0,226,674,224,6407
2017-08-13  14:33:20.156,666,1216,1100,2334,0,229,674,224,6443
2017-08-13  14:38:20.124,682,1216,1102,2336,0,229,682,224,6471
2017-08-13  14:43:20.158,686,1218,1104,2352,0,231,686,230,6507
2017-08-13  14:48:20.128,686,1220,1115,2370,0,233,686,230,6540
2017-08-13  14:53:20.130,688,1224,1122,2380,0,234,690,232,6570
2017-08-13  14:58:20.132,692,1232,1125,2398,0,234,692,232,6605
2017-08-13  15:03:20.133,694,1252,1133,2412,0,235,706,232,6664
2017-08-13  15:08:20.135,698,1260,1145,2426,0,237,710,232,6708
2017-08-13  15:13:20.170,700,1264,1149,2435,0,237,710,236,6731
2017-08-13  15:18:20.139,700,1280,1158,2455,0,240,710,236,6779
2017-08-13  15:23:20.140,716,1280,1159,2457,0,241,716,236,6805
2017-08-13  15:28:20.177,722,1280,1162,2473,0,242,722,242,6843
2017-08-13  15:33:20.145,722,1284,1173,2479,0,245,722,242,6867
2017-08-13  15:38:20.146,724,1288,1177,2489,0,245,726,244,6893
2017-08-13  15:43:20.148,724,1296,1183,2503,0,246,728,244,6924
2017-08-13  15:48:20.150,724,1306,1190,2517,0,246,740,244,6967
2017-08-13  15:53:20.184,726,1322,1199,2527,0,248,746,244,7012
2017-08-13  15:58:20.188,728,1326,1207,2543,0,249,746,248,7047
2017-08-13  16:03:20.155,728,1340,1213,2559,0,251,746,248,7085
2017-08-13  16:08:20.190,736,1344,1216,2565,0,253,748,248,7110
2017-08-13  16:13:20.158,750,1344,1217,2577,0,253,758,252,7151
2017-08-13  16:18:20.160,750,1346,1227,2595,0,256,758,254,7186
2017-08-13  16:23:20.194,752,1352,1230,2605,0,257,762,256,7214
2017-08-13  16:28:20.164,756,1356,1238,2621,0,258,762,256,7247
2017-08-13  16:33:20.166,756,1366,1239,2640,0,258,770,256,7285
2017-08-13  16:38:20.168,762,1384,1250,2651,0,260,780,256,7343
2017-08-13  16:43:20.208,764,1388,1262,2664,0,261,782,256,7377
2017-08-13  16:48:20.207,764,1398,1266,2676,0,262,782,260,7408
2017-08-13  16:53:20.209,766,1408,1271,2688,0,265,782,260,7440
2017-08-13  16:58:20.177,782,1408,1273,2694,0,265,790,264,7476
2017-08-13  17:03:20.179,786,1410,1279,2708,0,267,794,266,7510
2017-08-13  17:08:20.181,788,1414,1286,2726,0,269,796,266,7545
2017-08-13  17:13:20.184,788,1416,1295,2736,0,270,798,268,7571
2017-08-13  17:18:20.222,792,1430,1297,2758,0,270,804,268,7619
2017-08-13  17:23:20.187,798,1446,1306,2770,0,272,816,268,7676
2017-08-13  17:28:20.189,798,1452,1316,2784,0,273,818,268,7709
2017-08-13  17:33:20.226,800,1458,1322,2795,0,274,818,272,7739
2017-08-13  17:38:20.195,800,1472,1329,2809,0,277,818,272,7777
2017-08-13  17:43:20.197,814,1472,1330,2813,0,277,826,272,7804
2017-08-13  17:48:20.199,822,1474,1333,2829,0,279,830,278,7845
2017-08-13  17:53:20.202,822,1476,1344,2845,0,281,830,278,7876
2017-08-13  17:58:20.203,824,1480,1349,2857,0,282,834,280,7906
2017-08-13  18:03:20.206,828,1488,1354,2873,0,282,836,280,7941
2017-08-13  18:08:20.208,830,1504,1361,2887,0,283,850,280,7995
2017-08-13  18:13:20.210,834,1516,1374,2903,0,285,854,280,8046
2017-08-13  18:18:20.212,836,1520,1378,2912,0,285,854,284,8069
2017-08-13  18:23:20.214,836,1536,1385,2930,0,288,854,284,8113
2017-08-13  18:28:20.215,850,1536,1388,2934,0,289,858,284,8139
2017-08-13  18:33:20.251,858,1536,1391,2948,0,291,866,290,8180
2017-08-13  18:38:20.220,858,1538,1402,2964,0,293,866,290,8211
2017-08-13  18:43:20.222,860,1544,1404,2976,0,293,870,292,8239
2017-08-13  18:48:20.224,864,1552,1412,2992,0,294,872,292,8278
2017-08-13  18:53:20.227,866,1562,1417,3009,0,294,882,292,8322
2017-08-13  18:58:20.228,870,1578,1426,3022,0,296,890,292,8374
2017-08-13  19:03:20.231,872,1582,1436,3033,0,297,890,292,8402
2017-08-13  19:08:20.233,872,1594,1442,3045,0,298,890,296,8437
2017-08-13  19:13:20.235,876,1600,1445,3057,0,301,890,296,8465
2017-08-13  19:18:20.274,894,1600,1447,3067,0,301,900,300,8509
2017-08-13  19:23:20.239,894,1602,1458,3077,0,303,902,302,8538
2017-08-13  19:28:20.241,896,1608,1460,3097,0,305,906,304,8576
2017-08-13  19:33:20.243,898,1614,1470,3111,0,306,906,304,8609
2017-08-13  19:38:20.247,900,1628,1477,3127,0,306,916,304,8658
2017-08-13  19:43:20.247,906,1640,1486,3143,0,308,924,304,8711
2017-08-13  19:48:20.250,906,1644,1494,3157,0,309,926,308,8744
2017-08-13  19:53:20.253,908,1660,1498,3175,0,310,926,308,8785
2017-08-13  19:58:20.255,916,1664,1503,3181,0,313,928,308,8813
2017-08-13  20:03:20.257,928,1664,1505,3193,0,313,938,312,8853
2017-08-13  20:08:20.259,930,1666,1512,3203,0,315,938,314,8878
2017-08-13  20:13:20.295,932,1670,1518,3221,0,317,942,316,8916
2017-08-13  20:18:20.263,936,1674,1526,3237,0,318,942,316,8949
2017-08-13  20:23:20.263,936,1686,1531,3255,0,318,950,316,8992
2017-08-13  20:28:20.265,942,1702,1540,3267,0,320,960,316,9047
2017-08-13  20:33:20.266,942,1708,1552,3280,0,321,962,320,9085
2017-08-13  20:38:20.267,944,1726,1557,3296,0,322,962,320,9127
2017-08-13  20:43:20.270,956,1728,1561,3304,0,325,964,320,9158
2017-08-13  20:48:20.271,966,1728,1565,3312,0,325,972,324,9192
2017-08-13  20:53:20.273,966,1728,1571,3334,0,327,974,326,9226
2017-08-13  20:58:20.275,968,1734,1576,3348,0,329,978,328,9261
2017-08-13  21:03:20.276,972,1738,1586,3358,0,330,978,328,9290
2017-08-13  21:08:20.278,972,1752,1589,3376,0,330,992,328,9339
2017-08-13  21:13:20.280,978,1768,1602,3388,0,332,996,328,9392
2017-08-13  21:18:20.281,978,1772,1610,3404,0,333,998,328,9423
2017-08-13  21:23:20.283,980,1786,1614,3417,0,335,998,332,9462
2017-08-13  21:28:20.284,986,1792,1619,3427,0,337,1000,332,9493
2017-08-13  21:33:20.287,998,1792,1621,3437,0,337,1010,336,9531
2017-08-13  21:38:20.288,1002,1792,1627,3447,0,340,1010,338,9556
2017-08-13  21:43:20.290,1004,1798,1634,3465,0,341,1012,340,9594
2017-08-13  21:48:20.292,1008,1802,1641,3477,0,342,1014,340,9624
2017-08-13  21:53:20.328,1008,1814,1645,3500,0,342,1022,340,9671
2017-08-13  21:58:20.295,1014,1830,1656,3509,0,344,1032,340,9725
2017-08-13  22:03:20.298,1014,1836,1664,3524,0,345,1034,340,9757
2017-08-13  22:08:20.298,1016,1844,1671,3536,0,346,1034,344,9791
2017-08-13  22:13:20.300,1018,1856,1677,3550,0,349,1034,344,9828
2017-08-13  22:18:20.302,1034,1856,1679,3554,0,349,1042,348,9862
2017-08-13  22:23:20.305,1038,1858,1683,3568,0,351,1046,350,9894
2017-08-13  22:28:20.341,1038,1860,1692,3588,0,353,1046,350,9927
2017-08-13  22:33:20.343,1040,1864,1699,3596,0,354,1050,352,9955
2017-08-13  22:38:20.311,1044,1874,1702,3618,0,354,1052,352,9996
2017-08-13  22:43:20.313,1048,1892,1710,3632,0,355,1066,352,10055
2017-08-13  22:48:20.315,1050,1900,1722,3642,0,357,1070,352,10093
2017-08-13  22:53:20.352,1052,1906,1726,3652,0,357,1070,356,10119
2017-08-13  22:58:20.320,1052,1920,1735,3674,0,360,1070,356,10167
2017-08-13  23:03:20.322,1068,1920,1737,3674,0,361,1072,356,10188
2017-08-13  23:08:20.323,1074,1920,1739,3688,0,363,1082,362,10228
2017-08-13  23:13:20.326,1074,1922,1750,3708,0,365,1082,362,10263
2017-08-13  23:18:20.329,1076,1928,1752,3718,0,366,1086,364,10290
2017-08-13  23:23:20.329,1080,1936,1760,3734,0,366,1088,364,10328
2017-08-13  23:28:20.331,1082,1948,1767,3752,0,366,1100,364,10379
2017-08-13  23:33:20.332,1086,1962,1778,3764,0,368,1106,364,10428
2017-08-13  23:38:20.334,1088,1968,1784,3775,0,369,1106,368,10458
2017-08-13  23:43:20.337,1088,1980,1791,3791,0,372,1106,368,10496
2017-08-13  23:48:20.338,1098,1984,1793,3797,0,373,1108,368,10521
2017-08-13  23:53:20.340,1110,1984,1795,3809,0,374,1118,372,10562
2017-08-13  23:58:20.377,1110,1986,1808,3821,0,376,1118,374,10593
2017-08-14  00:03:20.343,2,6,0,18,0,1,2,2,31
2017-08-14  00:08:20.345,6,12,10,28,0,2,4,2,64
2017-08-14  00:13:20.347,6,24,15,49,0,2,14,2,112
2017-08-14  00:18:20.348,12,36,22,64,0,4,24,2,164
2017-08-14  00:23:20.350,14,44,34,76,0,5,24,6,203
2017-08-14  00:28:20.352,14,54,39,90,0,6,24,6,233
2017-08-14  00:33:20.353,20,62,43,100,0,9,24,6,264
2017-08-14  00:38:20.356,32,62,45,106,0,9,34,10,298
2017-08-14  00:43:20.358,36,64,53,120,0,12,36,12,333
2017-08-14  00:48:20.360,36,68,58,136,0,13,38,12,361
2017-08-14  00:53:20.362,40,72,66,146,0,14,40,14,392
2017-08-14  00:58:20.400,42,84,69,170,0,14,46,14,439
2017-08-14  01:03:20.401,48,100,78,180,0,16,58,14,494
2017-08-14  01:08:20.368,48,106,92,193,0,17,60,14,530
2017-08-14  01:13:20.403,50,112,94,209,0,18,60,18,561
2017-08-14  01:18:20.374,50,126,101,223,0,21,60,18,599
2017-08-14  01:23:20.398,68,126,103,227,0,21,68,18,631
2017-08-14  01:28:20.377,72,126,105,241,0,23,72,24,663
2017-08-14  01:33:20.380,72,130,116,257,0,25,72,24,696
2017-08-14  01:38:20.382,74,134,121,269,0,26,76,26,726
2017-08-14  01:43:20.384,78,144,126,291,0,26,78,26,769
2017-08-14  01:48:20.385,82,160,133,301,0,26,92,26,820
2017-08-14  01:53:20.387,84,170,144,313,0,29,96,26,862
2017-08-14  01:58:20.390,86,174,150,324,0,29,96,30,889
2017-08-14  02:03:20.393,86,188,157,344,0,32,96,30,933
2017-08-14  02:08:20.394,98,190,160,346,0,33,100,30,957
2017-08-14  02:13:20.397,108,190,163,358,0,35,108,36,998
2017-08-14  02:18:20.399,108,192,174,378,0,37,108,36,1033
2017-08-14  02:23:20.400,110,198,178,388,0,38,112,38,1062
2017-08-14  02:28:20.437,114,206,184,406,0,38,112,38,1098
2017-08-14  02:33:20.406,116,218,189,421,0,38,126,38,1146
2017-08-14  02:38:20.408,120,230,198,436,0,41,132,38,1195
2017-08-14  02:43:20.410,122,234,208,447,0,41,132,42,1226
2017-08-14  02:48:20.447,122,248,213,463,0,42,132,42,1262
2017-08-14  02:53:20.414,126,254,217,469,0,45,134,42,1287
2017-08-14  02:58:20.415,142,254,219,479,0,45,142,46,1327
2017-08-14  03:03:20.418,144,256,226,493,0,47,144,48,1358
2017-08-14  03:08:20.419,146,260,232,509,0,49,148,50,1394
2017-08-14  03:13:20.422,148,264,242,521,0,50,148,50,1423
2017-08-14  03:18:20.456,150,276,247,541,0,50,158,50,1472
2017-08-14  03:23:20.425,156,292,254,555,0,52,166,50,1525
2017-08-14  03:28:20.427,156,300,266,569,0,53,168,50,1562
2017-08-14  03:33:20.430,158,308,269,583,0,54,168,54,1594
2017-08-14  03:38:20.431,160,318,275,591,0,57,168,54,1623
2017-08-14  03:43:20.433,176,318,277,595,0,57,176,58,1657
2017-08-14  03:48:20.436,180,320,281,611,0,59,180,60,1691
2017-08-14  03:53:20.438,182,322,290,627,0,61,180,60,1722
2017-08-14  03:58:20.441,182,326,295,639,0,62,184,62,1750
2017-08-14  04:03:20.443,186,336,300,659,0,62,186,62,1791
2017-08-14  04:08:20.445,190,356,308,671,0,64,202,62,1853
2017-08-14  04:13:20.447,192,362,320,682,0,65,204,62,1887
2017-08-14  04:18:20.449,194,368,322,692,0,66,204,66,1912
2017-08-14  04:23:20.452,196,382,331,714,0,69,204,66,1962
2017-08-14  04:28:20.454,210,382,332,716,0,69,210,66,1985
2017-08-14  04:33:20.456,216,382,335,726,0,71,216,72,2018
2017-08-14  04:38:20.492,216,386,346,746,0,73,216,72,2055
2017-08-14  04:43:20.459,218,390,350,758,0,73,220,74,2083
2017-08-14  04:48:20.496,222,398,356,772,0,74,222,74,2118
2017-08-14  04:53:20.464,224,412,362,789,0,74,234,74,2169
2017-08-14  04:58:20.466,228,426,372,802,0,76,240,74,2218
2017-08-14  05:03:20.467,230,430,380,815,0,77,240,78,2250
2017-08-14  05:08:20.469,230,442,389,833,0,79,240,78,2291
2017-08-14  05:13:20.470,242,446,390,837,0,81,242,78,2316
2017-08-14  05:18:20.472,252,446,393,849,0,82,252,82,2356
2017-08-14  05:23:20.473,252,448,404,865,0,84,252,84,2389
2017-08-14  05:28:20.476,254,454,404,881,0,85,256,86,2420
2017-08-14  05:33:20.478,258,462,414,889,0,86,256,86,2451
2017-08-14  05:38:20.481,260,470,417,912,0,86,268,86,2499
2017-08-14  05:43:20.483,264,484,426,925,0,88,274,86,2547
2017-08-14  05:48:20.486,266,490,438,938,0,89,276,86,2583
2017-08-14  05:53:20.488,266,504,442,950,0,90,276,90,2618
2017-08-14  05:58:20.489,272,510,447,960,0,93,276,90,2648
2017-08-14  06:03:20.492,286,510,449,966,0,93,284,94,2682
2017-08-14  06:08:20.526,288,512,455,980,0,95,288,96,2714
2017-08-14  06:13:20.496,290,516,462,1000,0,97,290,98,2753
2017-08-14  06:18:20.497,292,518,471,1008,0,98,292,98,2777
2017-08-14  06:23:20.499,294,532,473,1032,0,98,300,98,2827
2017-08-14  06:28:20.501,300,548,484,1044,0,99,310,98,2883
2017-08-14  06:33:20.504,300,554,494,1053,0,101,312,98,2912
2017-08-14  06:38:20.506,302,560,499,1067,0,101,312,102,2943
2017-08-14  06:43:20.509,302,574,505,1083,0,105,312,102,2983
2017-08-14  06:48:20.511,320,574,507,1089,0,105,320,102,3017
2017-08-14  06:53:20.512,324,576,511,1101,0,107,324,108,3051
2017-08-14  06:58:20.547,324,578,520,1119,0,109,324,108,3082
2017-08-14  07:03:20.553,326,582,526,1129,0,110,328,110,3111
2017-08-14  07:08:20.519,330,592,530,1147,0,110,330,110,3149
2017-08-14  07:13:20.520,332,610,537,1159,0,111,344,110,3203
2017-08-14  07:18:20.554,336,618,548,1175,0,113,348,110,3248
2017-08-14  07:23:20.557,338,622,554,1184,0,113,348,114,3273
2017-08-14  07:28:20.526,338,638,561,1204,0,116,348,114,3319
2017-08-14  07:33:20.528,352,638,564,1206,0,117,354,114,3345
2017-08-14  07:38:20.529,360,638,567,1224,0,119,360,118,3386
2017-08-14  07:43:20.531,360,640,578,1236,0,121,360,120,3415
2017-08-14  07:48:20.532,362,646,582,1250,0,122,364,122,3448
2017-08-14  07:53:20.534,366,654,588,1266,0,122,366,122,3484
2017-08-14  07:58:20.537,366,668,593,1282,0,122,378,122,3531
2017-08-14  08:03:20.573,372,680,604,1294,0,125,384,122,3581
2017-08-14  08:08:20.540,374,684,612,1307,0,125,384,122,3608
2017-08-14  08:13:20.542,374,698,618,1323,0,126,384,126,3649
2017-08-14  08:18:20.544,380,702,621,1329,0,129,386,126,3673
2017-08-14  08:23:20.575,396,702,623,1341,0,129,396,130,3717
2017-08-14  08:28:20.547,396,704,634,1355,0,131,396,132,3748
2017-08-14  08:33:20.549,398,710,636,1369,0,133,400,134,3780
2017-08-14  08:38:20.551,402,714,646,1379,0,134,400,134,3809
2017-08-14  08:43:20.553,402,724,649,1403,0,134,410,134,3856
2017-08-14  08:48:20.555,408,740,658,1415,0,136,420,134,3911
2017-08-14  08:53:20.556,410,746,670,1427,0,137,420,134,3944
2017-08-14  08:58:20.559,410,758,675,1439,0,138,420,138,3978
2017-08-14  09:03:20.562,412,766,679,1453,0,141,420,138,4009
2017-08-14  09:08:20.562,430,766,681,1459,0,141,430,142,4049
2017-08-14  09:13:20.565,432,768,689,1473,0,143,432,144,4081
2017-08-14  09:18:20.566,434,772,694,1489,0,145,434,144,4112
2017-08-14  09:23:20.569,436,774,701,1501,0,146,436,146,4140
2017-08-14  09:28:20.570,438,786,705,1525,0,146,442,146,4188
2017-08-14  09:33:20.572,442,802,714,1533,0,147,452,146,4236
2017-08-14  09:38:20.574,444,810,724,1550,0,149,456,146,4279
2017-08-14  09:43:20.576,446,814,730,1558,0,149,456,150,4303
2017-08-14  09:48:20.577,448,830,737,1574,0,152,456,150,4347
2017-08-14  09:53:20.579,464,830,739,1576,0,152,462,150,4373
2017-08-14  09:58:20.581,468,830,741,1592,0,154,468,156,4409
2017-08-14  10:03:20.583,468,834,752,1610,0,156,468,156,4444
